111111111
1000000E1
1C00000P1
111111111