111111111111111
1000000000000E1
1C000P000000001
111111111111111