11111
1E001
1C001
1N001
10001
1P001
11111