11111111111111111111111
100000000000000000000E1
1C000001000000000000001
1C000001000000010000001
1C000001000000010000001
1C000001000000010000001
1C001111000000010000001
1C00100000000P000000001
11111111111111111111111