111111111111111
1000000000000E1
1C000P0100N0001
1C00010100N0001
111111111111111